9;9
#   #  ##
  # #    
#     ## 
#   #  # 
#   #    
#  ##  ##
#        
#   #  # 
# #    ##
