12;12
#   #  ##  # 
  # #     ##
#     ###  #
#   #  #   # 
#   #    #
#  ##  #### 
#           
#   #  #  ##
# #    ##  #
#   #  ##  # 
  # #     ##
#     ###  #
