12;12\n
##  #  ##  #\n 
#   #    #  \n
#  ##  #### \n
#           \n
#   #  #  ##\n
# #    ##  #\n
  # #     ##\n
#     ###  #\n
#   #  #   #\n
#   #  ##  #\n
  # #     ##\n
#     ###  #\n
