12;12
##  #  ##  # 
#   #    #  
#  ##  #### 
#           
#   #  #  ##
# #    ##  #
  # #     ##
#     ###  #
#   #  #   # 
#   #  ##  # 
  # #     ##
#     ###  #
