12;12
##  #  ##  #
 #   #    # 
 #   #  ####
 #          
 #   #  #  #
## #    ##  
#  # #     #
##     ###  
##   #  #   
# #   #  ## 
 #   # #    
 ###     ###
0